36
33
111111111111111111111111111111111111
100000001000000000001000000000100001
111110011001111111111111001000000101
100100001000000000001000011111111101
100111101111111100001100000000000101
100100000001000000001111111110000101
100000111111001111111001000100000001
100100010001000000010001110100011111
111111010001111100010000000101000001
100010010000100000010011111101111101
100010010100000100000000000001000001
100010011111111111111111110001010001
100000010000001000010000000001011111
100000010000001011110000111111000001
100111111111101000000100000000000001
100000010010001111111100001000100111
111111010010001000000000111111100001
100010010000001000000000010000000001
100010010011111000010000010010000001
110000010000000000010000010011110001
100111111111111000010000000010000001
100010010000000001111111111010011111
100010010000100000000000000010000001
100000011111111111111111111111111101
111111000000000000001000010010000101
100001111111111111101000010010000101
100000000000000000001001011010000101
100001111111111111111001000010110101
100000000000000100000001111010010001
101000010010000111111111000011011101
101111111110000100000100011110011101
100000000010000000100000000000001001
111111111111111111111111111111111111
